1 0 0 95 35 190 10 1
2 0 0 32 46 78 14 1
3 0 0 150 46 29 12 1
4 0 0 210 45 23 13 1
5 0 0 275 46 193 17 1
6 0 0 15 50 11 445 1
7 0 0 19 160 139 26 1
8 0 0 94 97 256 30 1
9 0 0 257 126 29 81 1
10 0 0 96 224 382 16 1
11 0 0 94 238 16 15 1
12 0 0 142 240 34 13 1
13 0 0 206 236 34 20 1
14 0 0 272 235 31 18 1
15 0 0 339 237 139 18 1
16 0 0 483 46 9 465 1
17 0 0 18 481 72 27 1
18 0 0 105 420 245 22 1
19 0 0 27 295 332 21 1
20 0 0 352 353 65 33 1
21 2 0 117 50 28 14 1
22 2 0 178 45 31 15 1
23 2 0 236 45 31 20 1
24 2 0 107 240 31 14 1
25 2 0 178 243 28 11 1
26 2 0 242 237 24 13 1
27 2 0 304 241 30 12 1
28 3 0 450 129 29 26 1
30 0 0 418 102 65 20 1
31 0 0 353 161 130 27 1
33 4 1 254 209 31 10 1
